###########----#######
#---------######-----#
#--------------#-----#
#--------------D-----#
#---------############
#####D#####-----------
#---------#-----------
#---------#-----------
#---------#-----------
#---------#-----------
###########-----------