###########----#######
#---------######-----#
#--------------#-----#
#--------------D-----#
#---------############
###########-----------