###########    #######
#---------######-----#
#--------------#-----#
#--------------D-----#
#---------############
###########